Y 3 0 0 0
G 3 1 0 1
W 3 0 1 3
R 2 1 3 1
O 2 0 4 2
B 4 1 6 2